33333333333333333333
10000030000303000003
32032030120303003003
30030032220003003303
30030030003003000303
30230030003000300303
30030032003020030303
30030000003000030303
32030032200302030303
30030030120301030301
30030030203200300303
30130030003330003003
33333333333333333333